111111111111111111
1P0001C00000000001
10C001111111110T01
100000000000000001
1E000000000C000001
100000C00000000001
111111111111000001
1C000000000000C001
111111111111111111
