11111111111111111111111111
1P0001C0000000000000000001
10C00111111111000000000001
100000000000000000000C0001
1E000000000C00000000000001
100000C0000000000000000001
11111111111100000000000001
1C000000000000C00000000001
10000000000000000000000001
10000000001111111111000001
10000000001000000000000001
100C0000001000000000000001
1000000000100000000C000001
11111111111111111111111111
